111111111
100100001
101000011
11100P011
111111111