R  589565465465   338                  

NO ./sm.xpm

SO ./sm.xpm

WE ./sm.xpm

EA ./sm.xpm

S ./sm.xpm

C 255,0,0

F 220,100,0

1111N111
11111111