R  1920 1080

NO ./sm.xpm

SO ./sm.xpm

WE ./sm.xpm

EA ./sm.xpm

S ./sm.xpm

C 225,30,0     
F 220,100,0


                                                   
111111111111111111111111111111111111111111111111111111111111
100000000000000000000000000000000000000000000000000000000001
111111111111111111111111110000000000001111111111111111111111
100000000000000000000000000000000000000000000000101010000001
100010000000000000000000000000000000000000000010001010000001
100000000000000000000000000000000000000000000010101000000001
100000000000000000000000000000000000000000000010101010000001
100000010000000000000000000000000000000000000010100010000001
111111111111111111111111111111111111111111111111111111111111