R 1920 1080

NO ./path_to_the_north_texture

SO ./path_to_the_south_texture

WE ./path_to_the_west_texture

EA ./path_to_the_east_texture


S ./path_to_the_sprite_texture

F 220,100,0

C 225,30,0

                                                   
    11111 1111111 11111111111111 1111111 111 111111 
       111111   1111111       111111   1111   1111  
    10000010111110000011111111100001111100011100001  
111111111111111111111111111111111111111111111111111







1111111111111111111111111111111111111111111111111111
1000000000000100000000010000000000000000000000000001
1000000100111000100000001000000010000000100000000001
1  1000001   1110000000000000000000000000000000001
   11111 1111111111111111111111111111111111111111