R  1000   700                  

NO ./sm.xpm

SO ./sm.xpm

WE ./sm.xpm

EA ./sm.xpm

S ./sm.xpm

C 255,255,255

F 0,0,0



        111111111111111111111111           
        1000000000000000000000001
        100000000N000000000000001           
        10000000020000000000000011111111111
11111111100000000000000000000000111111
11000000000000000111110000000000011111111111
10000000000000011  10000000001111111     
1100000000000000011110000000000001    
100000000000000000000000000111111
10000000000000000000000000001
10000000000000000000000000001     
1000000010000000100000000000111
10000001 1000001 100000000001 
11111111 1111111 111111111111