R                   1920 1080
F




        111111111111111111111111           
        1000000000000000000000001
        1000000000000000000000001           
        10000000000000000000000011111111111
11111111100000000000000000000000111111
11000000000000000111110000000000011111111111
10000000000000011  10000000001111111     
1100000000000000011110000000000001    
000000000000000000000000000111111
10000000000000000000000000001
10000000000000000000000000001     
1000000010000000100000000000111
10000001 1000001 1000000000010
11111111 11111110111111111111