R 2500 2000
NO ./sm.xpm
SO ./sm.xpm
WE ./sm.xpm
EA ./sm.xpm
S ./sm.xpm
C 138,43,226
F 255,255,255

11111111111111111         11111111111111111   11111111111111111   11111111111111111
1E000000000000001         10000000000000001   10000000000000001   10000000000000001
10000000000000001         10000000000000001   10000000000000001   10000000000000001
11111111111111001         11111111111111001   11111111111111001   11111111111111001
             1001                      1001                1001                1001
             1001                      1001                1001                1001
             1001                      1001                1001                1001
             1001         11111111111111001   11111111111111001                1001
             1001         10000000000000001   10000000000000001                1001
             1001         10000000000000001   10000000000000001                1001
             1001         11111111111111001   11111111111111001                1001
             1001                      1001                1001                1001
             1001                      1001                1001                1001
             1001                      1001                1001                1001
             1001         11111111111111001   11111111111111001                1001
             1001         10000000000000001   10000000000000001                1001
             1001         10000000000000001   10000000000000001                1001
      11111111001111111   11111111111111001   11111111111111001                1001
      11111111001111111   11111111111111001   11111111111111001                1001
      11111111001111111   11111111111111001   11111111111111001                1001
       111111000111111111111111111111111001111111111111111110011111111111111111001 
        1000000000000000000000000000000000000000000000000000000000000000000000001  
         10000000000000000000000000000000000000000000000000000000000000000000001   
          111111111111111111111111111111111111111111111111111111111111111111111    