R 100 10000
NO ./wall7.xpm
SO ./wall8.xpm
WE ./wall9.xpm
EA ./wall10.xpm
S ./sm.xpm
C 00,00,0
F 00,0,00

11111111
10000001
10000001
10000001
1000S001
10000001
10000001
11111111