R 2500 2000
NO ./sm.xpm
SO ./sm.xpm
WE ./sm.xpm
EA ./sm.xpm
S ./sm.xpm
C 138,43,226
F 255,255,255

   1111111111111111111111111111111111
   1000000000000000000000000000000001
   1000000000000E00000000000000000001
1111000001101010111111111111111100001
1000000000000000000000000000000001111
1000000000000000000000000000000001
1000000000000000000000000000000001
1000000000000000000111000000000001
1000000000000000000111000000000101
1000000000000000000111000000000101
1000001000000010000000111000000101
1000000000000000000000111000000101
1000000000000000000000111000000101
1000000000000000000000000000000101
1000000000000001000000000000000101
1000000000000000000000000000000101
1000000000000000000010000000000101
1000000000000000000000000000001001
1111111111111111111111111111111111