R 2450 750
NO ./sm.xpm
SO ./sm.xpm
WE ./sm.xpm
EA ./sm.xpm
S ./sm.xpm
C 138,43,226
F 255,0,255

                 1111111           11111111111
                100S0001          1000000000001  
               10000001           1000111100001
              10000001            11111  100001 
             10000001                    100001
            10000001                    100001
           10000001  1111              100001
          10000001  10001             100001
         1000000111110001111         100001
         1000000000000000001        100001
         1000000000000000001       1000001
         1111111111100001111      1000000111111
                   100001         1000000000001
                   100001         1111111111111
                   111111