R 1000 10000
NO ./wall7.xpm
SO ./wall7.xpm
WE ./wall7.xpm
EA ./wall8.xpm
S ./sprite.xpm
C  151,200,100
F  100,100,200  

111111111111111
120020000000121
10002E000000011
102000200000001
100002000000001
120020000000001
120000000000021
111111111111111
111111111111111