R 2000 2000
NO ./sm.xpm
SO ./sm.xpm
WE ./sm.xpm
EA ./sm.xpm
S ./sm.xpm
C 138,43,226
F 255,255,255

1111111111111111111111111111111111111111
1000000000000000000000000000000000000001
1000000000000000000000000000000000000001
1000000000000000000000000000000000000001
1000000000000000000000000000000000000001
1000000000000000000000000000000000000001
1000000000000000000000000000000000000001
1000000000000000000111000000000000000001
1000000000000000000111000000000100000001
1000000000000000000111000000000100000001
100000000000000000000N111000000100000001
1000000000000000000000111000000100000001
1000000000000000000000111000000100000001
1000000000000000000000000000000100000001
1000000000000000000000000000000100000001
1000000000000000000000000000000100000001
1000000000000000000000000000000100000001
1000000000000000000000000000001000000001
1000000000000000000000000000010000000001
1000000000000000000000000000100000000001
1000000000000000000000000001000000000001
1000000000000000000000000010000000000001
1000000000000000000000000100000000000001
1000000000000000000000001000000000000001
1111111111111111111111111111111111111111