R 10000 10000
NO ./wall7.xpm
SO ./wall8.xpm
WE ./wall9.xpm
EA ./wall10.xpm
S ./sm.xpm
C  100,200,100
F  100,100,200  

111111111111111
100000000000001
100000000000001
100000000000001
1000S0000000001
100000000000001
100000000000001
111111111111111