F 255,255,255 

R 50000000 500000000
NO ./wall7.xpm
SO ./wall7.xpm
WE ./sprite.xpm
EA ./wall8.xpm
S ./sprite.xpm
C  0,0,0

1111111111
1          1
11111111111
111 111101
1111 101111111
1111110000000111
122222111222221111
122222E222222111
1222222222222221
1111111111111111
1           1
11111111111