R 10000 10000
NO ./wall7.xpm
SO ./wall7.xpm
WE ./wall7.xpm
EA ./wall8.xpm
S ./sprite.xpm
C  100,200,100
F  100,100,200  

111111111111111
120000000000121
100000000000011
100000000000001
1000E0000000001
100000000000001
120000000000021
111111111111111