R     4000 4000
F 


   






   




1
1
1111
111
1111