R  5000 5022       
NO ./xpms/wall7.xpm
SO ./xpms/wall9.xpm
WE ./xpms/wall10.xpm
EA ./xpms/wall8.xpm
S    abc.xpm
F  255,255,255 
C  90,65,54



        111111111111111111111111
        1000000000000000000000001
        1000000000000000000000001           
        1000000002000000S000000011111111111
11111111100000000000000000000000111111
11000000000000000111110000000000011111111111
10000000000000011  10000000001111111     
110000000000000001110000000000001    
100000000000000000000000000111111
1000000000000000000000000001
10000000000000000000000000001     
1000000010000000100000000000111
10000001 1000001 100000000001 
11111111 1111111 111111111111