R 5000 900
NO ./xpms/wall8.xpm
SO ./xpms/wall9.xpm
WE ./xpms/wall10.xpm
EA ./xpms/wall7.xpm
S ./xpms/sprite.xpm
F 123,21,144 
C 11,29,83

11111111111111111         11111111111111111   11111111111111111   11111111111111111
10000000000000001         10000000000000001   10000000000000001   10000000000000001
10000000000000001         10000000000000001   10000000000000001   10000000000000001
11111111111111001         11111111111111001   11111111111111001   11111111111111001
             1001                      1001                1001                1001
             1001                      1001                1001                1001
             1001                      1001                1001                1001
             1001         11111111111111001   11111111111111001                1001
             1001         10000000000000001   10000000000000001                1001
             1001         10000000000000001   10000000000000001                1001
             1001         11111111111111001   11111111111111001                1001
             1001                      1001                1001                1001
             1001                      1001                1001                1001
             1001                      1001                1001                1001
             1001         11111111111111001   11111111111111001                1001
             1001         10000000000000001   10000000000000001                1001
             1001         10000000000000001   10000000000000001                1001
      1111 111001111111   11111111111111001   11111111111111001                1001
      11111111001111111   11111111111111001   11111111111111001                1001
      11111111001111111   11111111111111001   11111111111111001                1001
       11111100111111111111111111111111001111111111111111110011111111111111111001 
        10W0000000000000000000000000000000000000000000000000000000000000000000001  
         10000000002222222222222222222222222222222222222222222222222222220000001   
          111111111111111111111111111111111111111111111111111111111111111111111    